11111111T11111111111111
10000000000C00001100001
10000C00000000001100C01
11111000000000111100011
11111111000000001110011
11111100000000000000001
11111111111111110001111
11111111100000000C00111
111P000C000011111111111
11111111111111111111111