1111111111111111111111111
1000000000000000111111111
1111110000000000011111111
1000000000000111111111111
1000000000000000000000E11
1111110000000011111111111
1111111111110000000111111
11111111P0000000000001111
1111111111111111111111111