1111111111111
100100000E0C1
1000011111001
1P00110000000
1111111111111