111111111111111111111111
100000000C10C0001C000C11
10000C110010000011110011
10C000110010000000010011
100000110000000000010011
1000001111E1111110000001
100000011111111111111111
111110000C0000000C011111
111000000000000111111111
111111P000000C0111111111
111111111111111111111111
