111111111111111111111111111111
110C000000000000000000000000C1
111000000000000000C00000000001
111111111111111000000011111111
1111111111110000000000011110C1
1111P0000000000000000000111001
110C0000000000C0000011111100E1
1000000000000000001111111C0001
111111111000000000000C00000111
111000000000000000000000111111
10000C000111111111111111111111
1111000001111111111C0000000111
111110000000000000000000C00111
111111111111111111111111111111