11111111111111111111
10C0000000C000000C01
10000000001000000001
10C00111111111100C01
10000000011000000001
1P00000C011E00000001
11111111111111111111